222022200220
200002002000
222002002000
200002002000
222002000220
000000000000
115511551155
110011001100
