003353300000
030000030004
050000050004
030000030004
003000300004
003003000004
000050000004
000030000004
000030000004
000000000000
000050000005
