444444444444
444444444444
555555555555
444444444444
444000000444
445444444544
000000000000
000000000000
555000000555
545454545454
