011100001110
003000000300
000011100000
000003000000
000000000000
000400003330
005550000400
000002000000
020011100020
111000000111
