000000000000
111555555111
100000000001
100400004001
104440044401
100000000001
103555555301
103333333301
100000000001
111555555111

