222211114444
222255554444
222211114444
255211114554
222211114444
222211114444
151515151515
515151515151
