555555555555
111111111111
111000000111
110000000011
221000000122
111100001111
111111111111
522222222225
454444444454