000000000000
000000000000
251113521151
125252252111
521114121515
400005000004
152214211511
125252252111
521114121515
