03300400040
30004440444
30000400040
03300000000
00055555000
00000000000
11511111511